1;3;6;9;17;17
MMMMMMMMMMMWWWWWWWWWWWwww
M         MW            w
M  B   B  MWWWWW WWWWWw w
M B     B MWBBBB BBBB w w
M         MRB       B w w
M    E         w    B w w
M         MRB  B    B w w
M B     B MBB  w    BBB B
M  B   B  MB            B
M         MB        BBBBB
MMMMMMMMMMMBBBBBBBBBB
